111211111111111
111211111111111
111211111111111
111111112211111
111111112211111
111111111111111
111111111111111
111111111111111
111111221111111
111111211112222
111111211111111
111111211111111
112111111111111
222111111111111
111111122211111
111111111111111
111111111111111
111111111222111
111111111111111
111111111111111
